. . . . . . . . . . . . . . . . . . . . . . . . . . . . . . . . 
. . . . . . . . . . . . . . . . . . . . . . . . . . . . . . . . 
. . . . . . . . . . . . . . . . . . . . . . . . . . . . . . . . 
. . . . . . . . . . . . . . . . . . . . . . . . . . . . . . . . 
. . . . . . . . . . . . . . . . . . . . . . . . . . . . . . . . 
. . . . . . . . . . . . . . . . . . . . . . . . . . . . . . . . 
S 0 0 . 0 0 0 0 0 0 0 0 0 0 0 0 0 0 0 0 0 0 0 0 0 0 0 0 0 0 0 B 
. . 0 . 0 . . . . . . . . . . . . . . . . . . . . . . . . . . . 
. . 0 . 0 . . . . . . . . . . . . . . . . . . . . . . . . . . . 
. . 0 . 0 . . . . . . . . . . . . . . . . . . . . . . . . . . . 
. . 0 0 0 . . . . . . . . . . . . . . . . . . . . . . . . . . . 
. . . . . . . . . . . . . . . . . . . . . . . . . . . . . . . . 
. . . . . . . . . . . . . . . . . . . . . . . . . . . . . . . . 
. . . . . . . . . . . . . . . . . . . . . . . . . . . . . . . . 
. . . . . . . . . . . . . . . . . . . . . . . . . . . . . . . . 
. . . . . . . . . . . . . . . . . . . . . . . . . . . . . . . . 
. . . . . . . . . . . . . . . . . . . . . . . . . . . . . . . . 
. . . . . . . . . . . . . . . . . . . . . . . . . . . . . . . . 

PATH: 0/6 1/6 2/6 2/7 2/8 2/9 2/10 3/10 4/10 4/9 4/8 4/7 4/6 5/6 6/6 7/6 8/6 9/6 10/6 11/6 12/6 13/6 14/6 15/6 16/6 17/6 18/6 19/6 20/6 21/6 22/6 23/6 24/6 25/6 26/6 27/6 28/6 29/6 30/6 31/6 